F 255     ,     200, 100
C    10    ,0,    255


NO ./textures/north.xpm


SO ./textures/south.xpm
WE ./textures/west.xpm


EA       ./textures/east.xpm     


11111                
10001     
100S1   
11111