F 255     ,     200, 100
C    10    ,0,    255


NO ./textures/north.xpm


SO ./textures/south.xpm
WE ./textures/west.xpm


EA       ./textures/east.xpm


111111111111111111
100000000100000011
100011000000100011
10W000110001001011
100000000000000011
111111111111111111