F 255     ,     200, 100
C    10    ,0,    255


NO ./textures/north.xpm


SO ./textures/south.xpm
WE ./textures/west.xpm


EA       ./textures/east.xpm


111111
100011
100011
100011
100N11
111111