F 128     ,     128, 128
C    0    ,0,    0


NO ./textures/north.xpm


SO ./textures/south.xpm
WE ./textures/west.xpm


EA       ./textures/east.xpm


111111111111111111
100000000100000011
100000000000100011
100000000001001011
100000000000000011
111111111111111111