F 255     ,     200, 100
C    173    ,216,    230


NO ./textures/north.xpm


SO ./textures/south.xpm
WE ./textures/west.xpm


EA       ./textures/east.xpm


111111111111111111
100000000100000011
100000000000100011
1000000000E1001011
100000000000000011
111111111111111111