NO ./textures/north.xpm
SO ./textures/south.xpm
WE ./textures/west.xpm
EA               ./textures/east.xpm            

F    23, 23, 32
C 200     ,200         ,200

1111111        1111111111
110000011      10000000001
100000001     1000000000001                             
 1000001     100000000000011
  11011      1000000000000001
   101        1000000100000001
   101         100001 100000001
   101111111111100000100000001111
   10000000000000000000000S000001
   1000000000000000000000000000001
   1111111111111111111111111111111
   100000000000000000000000000001
   100000000000000000000000000001
   10111111111110000000000011111
   101         100000000001
   101        100000000001
  11011      100000000001
 1000001     100000000001
100000001     10000000001
110000011      1000000001
 1111111        111111111
