F 128,128,128
C 128,0, 0


NO ./textures/north.xpm
SO ./textures/south.xpm
WE ./textures/west.xpm
EA ./textures/east.xpm


                1111111111111111111111111
                10000000001100000000000010           
                10110000011100000000000010    
                10010000000000000N00000010       
        1111111110110000011100000000000010   
        100000000011000001110111111111111
        11110111111111011100000010001
        11110111111111011101010010001       
        11000000110101011100000010001
        10000000000000001100000000001
        10000000000000001101010010001       
        1100000111010101111101111000111
        11110111 1110101 101111010001
        11111111 1111111 111111111111       